  10000000000
  1111111111
  1111111110
  1111111101
  1111111100
  1111111011
  1111111010
  1111111001
  1111111000
  1111110111
  1111110110
  1111110101
  1111110100
  1111110011
  1111110010
  1111110001
  1111110000
  1111101111
  1111101110
  1111101101
  1111101100
  1111101011
  1111101010
  1111101001
